1,1,1,1,1
1,0,0,0,1
1,0,b,0,1
1,0,2,p,1
1,0,0,0,1
1,1,1,1,1
