1,1,1,1,1,1,1,1,1,1,1,1,1
1,1,0,0,0,0,0,0,0,0,0,0,1
1,1,b,1,0,1,1,1,1,0,1,0,1
1,1,2,1,0,1,1,1,1,0,1,1,1
1,1,b,1,0,0,0,0,0,0,0,p,1
1,1,0,1,1,0,1,1,1,1,1,0,1
1,1,0,0,0,0,0,0,0,0,0,0,1
1,1,1,1,1,1,1,1,1,1,1,1,1
